-------------
|...........|
|..@....`^<.|
|...........|
-------------
