-------------
|...........|
|..@....`^..|
|...........|
-------------
