|--------------|
|..............|
|------|.|---|.|
       |.|   |.|
       |.|---|.|
       |.......|
       ---------

