   --------
 ---.|....|
 |...`....|----------
 |.-.``-``|.|.......|
 |.``-......|.......|
 |.-..`.|...|.......|
 |....-`--`-|...<...|
 |..``..`...|.......|
 |.--...|...|.......|
 |....-`|---|.......|
 ---..`.-----------.|
   |..`@^^^^^^^^^^^.|
   ------------------
 
