  ----          -----------
 --.@--------   |.........|
 |..........|   |.........|
 |.`-----`-.|   |.........|
 |..|...|.`.|   |....<....|
 |.`.`....`-|   |.........|
 |.`..`..|..|   |.........|
 |.----`.--.|   |.........|
 |..`...`.|.--  |.........|
 |.---`-...`.------------.|
 |...|..`-.`.^^^^^^^^^^^^.|
 |..`......----------------
 -----..|..|
     -------
 
