 --------------------
 |........|...|.....|
 |.``..-``|.-.|.....|
 |..|.`.`.|``.|.....|
 |-.|..-..|.-.|..<..|
 |...--.......|.....|
 |...|.`.-...-|.....|
 |.`.|`.|...--|.....|
 |-`.|..-----------.|
 |..`....^^^^^^^^^^.|
 |...|.@-------------
 --------
 
