 --------------------------
 |@......^^^^^^^^^^^^^^^^.|
 |.......----------------.|
 -------.------         |.|
  |...........|         |.|
  |.`.`.`.`.`.|         |.|
 --------.----|         |.|
 |...`.`..`.`.|         |.|
 |...`........|         |.|
 -----.--------   ------|.|
  |..`.`.`...|  --|.....|.|
  |.....`....|  |X......|.|
  |.`.`...`.--  |-|.....|.|
 -------.----   |X........|
 |..`.....|     |-|.....|--
 |........|     |X......|
 |...------     --|.....|
 -----            -------
 
