   ------------------------
   |..^^^^^^^^^^^^^^^^^^..|
   |..-------------------.|
 ----.|    -----        |.|
 |..|`--  --...|        |.|
 |.....|--|.`..|        |.|
 |.``..|..|..`.|        |.|
 --..``|...``.--        |.|
  |`..`...|`..|   ------|.|
  |.``.|..|..`| --|.....|.|
  |.`.`---|.`.| |X......|.|
  |.......|..-- |-|.....|.|
  ----.`..|.--  |X........|
     ---.--.|   |-|.....|--
      |.`...|   |X......|
      |@.|..|   --|.....|
      -------     -------
 
